WWWWWWWWWWWWWWWWWWWWWWWWWWWWWWWWWWWWWWWWWWWWWWWWWWWWWWWWWW
W                             W                          W
TR                            W                          T
T                             W                          T
T                         WWWWW                          T
W             G           W                              T
W             G           W                              T
W             G           W                              T
T                                                        T
T                                                        T
T                                                        T
W                                                        W
WWWWWWWWWWWWWWWWWWWWWWWWWWWWWWWWWWWWWWWWWWWWWWWWWWWWWWWWWW
